25 25 0 0 20 9
M-M- M-M- MM-- M--M MM-- M--M MM-- MM-M M--M MM-- M--M MM-- M--M M-M- MM-- M--M M--- M-M- M--- MMM- M--M M-M- MM-- M--M MM--
M--M MM-- ---M -MM- --MM -MM- -M-M --MM -M-- -M-M -M-M -MMM -M-M M--M -MM- -MMM --MM MM-- --MM MM-- --MM MM-- -M-M -M-M -MMM
-M-M -M-M -M-M M--M M-M- M-M- -MM- M--M -MM- -M-M -M-M M--M -MM- --MM M-M- MM-- M--M -MM- -MM- -M-M M--M -MM- --MM --M- MM--
-M-M ---M -MM- -MMM M--M MM-- M-MM --M- MM-- --MM -M-- --MM MMM- M--M M-M- -MM- -M-M MM-M -M-M -MMM -M-M M--M M-M- MMM- -M-M
-MMM --MM MM-- M--M -MM- -M-M M--M MM-- ---M MMM- --MM M-M- MM-- ---M M-M- M-M- -MM- -M-M --MM M-M- -MM- --MM M-M- MM-- -M-M
M--M M-M- -MM- -M-M M--M -MM- -M-M --MM --M- M-M- MM-- M--M -MM- --MM M-M- M-M- MM-- ---M M-M- M-M- M--- MM-- MM-M -M-M -M-M
-M-M MM-M M--M -MM- -MMM M--M -MM- M--M MM-- M--M -MM- -M-M M--M MM-- MM-M M--M -M-- ---M M-M- MMM- -M-M --MM -MM- --MM -MM-
-M-M -M-M -M-M M--M MM-- ---M MMM- -M-M -M-M --MM MM-- -M-M -MMM ---M -MM- -M-M -M-M -M-M M-MM M--- -MM- M--M MM-- M--M MMM-
-M-M -M-M -M-M -M-M -MMM -M-M M--M -MM- --MM MMM- -M-M --MM M-M- -MM- M--M -MM- --MM -M-- M--M -MM- M-MM -MM- -M-M --MM MM--
-M-M ---M -MM- ---M M-M- -MM- ---M MM-- M--M MM-- --MM M-M- MM-- M-MM -MM- M--M M-M- -MM- --MM MM-- M--M MM-- --MM MM-- -M-M
-M-M --MM M--- -MM- M--M MMM- -M-M ---M -MM- --MM MM-- M--M --M- M-M- MM-- --MM MM-- M--M M-M- -MM- -MMM --MM MM-- -M-M -M-M
-M-M M--M -MM- MM-M ---M M-M- -MM- -M-M M-MM MM-- -M-M --MM M-M- MM-- --MM M-M- -M-- --MM MM-- M--M M-M- MM-- -M-M --MM -M--
-M-M -M-M M--M -M-- --MM MM-- M-MM --M- MM-- -M-M -M-M MM-M M--M -MM- M--M MMM- --MM MM-- -M-M -MMM M--M --M- --M- M-M- -MM-
--MM -MM- -MMM --MM M-M- --M- M--- MM-- --MM -MM- M--M -MM- --MM MM-- --MM M-M- M-M- -MM- ---M MM-- -M-M M--M M-M- M-M- MM--
M--M MM-- M--M M-M- MM-- M-MM -M-- --MM M-M- M-M- M-M- M-M- MM-- ---M M--- MM-- M--M M--- -M-- -M-M --MM -MM- M--M M-M- -MM-
-M-M -M-M -M-M M--M -MM- M--M -MM- M--M MM-- M--M M-M- MM-- --MM -MM- -MMM -M-M -MMM -M-M -M-M -M-M M--M M-M- -MM- M--M MMM-
-M-M --MM -M-- --MM MM-- -M-M M--M -MM- --MM --M- MMM- --MM M--- MM-- M--M --M- MM-- -M-M -MMM --MM -MM- M-MM MM-- --MM MM--
---M MMM- -M-M MM-M -M-M -M-M -M-M M-MM M--- MM-- M--M MM-- -M-M -M-M --MM MM-- -M-M ---M M-M- M-M- M-M- M-M- -MM- M--M -M--
-M-M M--M -MM- -M-M --MM -MM- -M-M M--M -MM- -M-M -MMM -M-M -M-M --MM MM-- -M-M -M-M -MMM M--M M-M- M-M- M-M- M-M- -MM- -M-M
-MMM -M-M M--M -M-- M--M M-M- -MM- ---M MM-- --MM M--- -MM- --MM MMM- --MM -M-- ---M MM-- -M-M M--M M-M- MM-- M-MM MM-- -M-M
M--M -MM- -M-M --MM --M- M-M- MM-- -MMM --MM MM-- --MM M-M- MM-- M--M M-M- -MM- -M-M ---M -M-- ---M MMM- --MM MMM- -M-M -M-M
-M-M M-MM -MM- M--M M-M- MMM- --MM M-M- MM-- -M-M M--M MM-- --MM -MM- MM-M M--M -MM- -MMM -M-M -M-M M--M M-M- M-M- -MM- -M-M
--MM M-M- MM-- --MM M-M- M-M- M--- MM-- -M-M -M-M -MMM -M-M M--M MM-- -M-M --MM M-M- MM-- --MM -MM- --MM MM-- M--M MM-- -M-M
MM-M M--M -MM- M--M MM-- M--M -MM- ---M -MM- --MM MM-- --MM -MM- -M-M ---M M-M- MM-- -M-M M--M M-M- MM-- -M-M -M-M -M-M -M-M
--MM -MM- M-MM -MM- --MM -MM- M-MM --M- M-M- MMM- --MM M-M- M-M- -MM- --MM MMM- --MM --M- -MM- M-MM -MM- --MM -MM- --MM --M-
